0111111111111111111111111110
0100000000000000000000000010
0101110001111111111100111010
0131000000000010000000001110
0101011000001111100011101010
0101010000000010000000101010
0101110000111111111000131010
0100010000000000000000100010
3100010110001000100010100011
0000010011601000101310100000
0001011000601111100010100000
1101000000000010000013104011
0101005551110010077000004010
0100000000000010000011100010
0100000100010010010000001010
0102001111110010011100001010
0102000100000010000000001010
0100011110001111100111100010
0100000000000000000100000010
0111111111111111111111111110

