0000000000000000000000000000
0000100111110011111001011100
0000100001000000100001010000
0110001003001100100100010110
0000101001000000100101010010
0000103001000000100101000000
0000101000000000000101111110
0111101011113111110100000000
0000001000000000000111311110
0011111000000000000000000000
0000000011100001110111111100
0011111010000000010300000000
0000001011111111110101311100
0111101000000000000101000000
0000101011111111110101000010
0000101000000000000101011110
0000101310011310010101010000
0000100010010010010101010110
0000101010011110010101010100
0000000000000000000000000000