11111111111111111111
10000000010000000001
10111011010111010101
10000000000000000001
10110100111001011101
10000110010011000001
11110100000001011111
10000001000100000001
11110101111101011111
10000000000000000001
10110100111000101101
10010110010011101001
11010011000111001011
10000000010000000001
11111111111111111111
